@@@@@@@@@@@@@@@@
@    @         @
@  @@@  @@@@@B @
@    @      @@ @
@    @@   @@@  @
@         @    @
@   @@@   @    @
@ @@@          @
@ A @@@@  @@  @@
@   @          @
@@@@@@@@@@@@@@@@