@@@@@@@@@@@@@@@@
@           @  @
@  @@@@@@@ @@B @
@    @     @   @
@    @@   @@ @@@
@     @   @    @
@   @@@  @@@@  @
@ @@@     @    @
@ A @@@@  @@  @@
@   @          @
@@@@@@@@@@@@@@@@